R 750 750                                    

NO ./texture/north.xpm
SO ./texture/south.xpm
WE ./texture/west.xpm              
EA ./texture/east.xpm                          
S ./texture/1111.xpm

C  255, 255, 169         
F 111,111,111

        1111111111111111111111111
        1000000000110000000000001
        1011000001110000002000001
        1001000000000000000000001
111111111011000001110000000000001
100000000011000001110111111111111
11110111111111011100000010001
11110111111111011101010010001
11000000110101011100000010001                         
10002000000000001100000010001
100000W0000000001101010010001
110000011101010111110111100011111111
11110111 1110101 101111010001
11111111 11111111111111111111